11111111111111111111111111111111
1....U...................C.....1
1..............................1
1.............C................1
1.C........................C...1
1.......11111......11111.......1
1.......1......U.......1.......1
1.......1..............1.......1
1...U...1........C.....1...C...1
1.......1..............1.......1
1..............................1
1..............11.........M....1
1..............11..............1
1..P...........................1
1.......1......C.......1.......1
1.......1..............1.......1
1.......1..............1.......1
1...C...1..............1..U....1
1.......11111......11111.......1
1..............................1
1...............U..............1
1...C....................C.....1
1...........C..................1
11111111111111111111111111111111
